#######
#  P  #
# B H #
#     #
#######
